5
WWWWWWWWWWWWWWW
WDDDDDMDDDDDMDW
WDHDDDDDDDDDDDW
WDDDDDDDDMDDDDW
WDDDDDDDDDDDMDW
WDDMDDDDDDDDDDW
WDDDDDDMDDDDDDW
WDDDDDDDDDDDMDW
WDDDDDDDDDDDDDW
WDDDDDDDDMDDDDW
WDMDDMDDDDDDDDW
WDDDDDDDDDDDDDW
WDDDDDDDDDDDSMW
WDDDDDDDDDMDDDW
WWWWWWWWWWWWWWW
